144 129 129 129 129 129 129 129 129 129 129 129 129 129 129 129 129 129 129 129 129 129 129 132 130 130 130 130 130 130 130 130 130 130 130 130 130 130 130 130 130 130 130 130 144 129 129 129 129 132 
139 75 76 75 76 75 76 75 76 75 76 75 76 75 76 75 76 75 76 75 76 75 76 131 130 130 130 130 130 130 130 130 130 130 130 130 130 130 130 130 130 130 130 130 139 45 48 48 51 143 
139 73 74 73 74 73 74 73 74 73 74 73 74 73 74 73 74 73 74 73 74 73 74 131 130 130 130 130 130 130 130 130 130 130 130 130 130 130 130 130 130 130 130 130 139 46 2 2 52 136 
139 71 72 71 72 71 72 71 72 71 72 71 72 71 72 71 72 71 72 71 72 71 72 131 130 130 130 130 130 130 130 130 130 130 130 130 130 130 130 130 130 130 130 130 139 46 2 2 52 136 
139 53 54 55 56 75 76 75 76 75 76 75 76 75 76 75 76 75 76 75 76 75 76 131 130 130 130 130 130 130 130 130 130 130 130 130 130 130 130 130 130 130 130 130 139 46 2 2 52 136 
139 57 58 59 60 73 74 73 74 73 74 73 74 73 74 73 74 73 74 73 74 73 74 131 130 130 130 130 130 130 130 130 130 130 130 130 130 130 130 130 130 130 130 130 139 46 2 2 52 136 
139 61 62 63 64 71 72 71 72 71 72 71 72 71 72 71 72 71 72 71 72 71 72 128 129 129 129 129 129 129 129 129 129 129 129 129 129 129 129 129 129 129 129 129 140 46 2 2 52 136 
139 65 66 67 68 45 48 48 48 48 48 48 48 48 51 75 76 75 76 75 76 75 76 75 76 75 76 75 76 75 76 75 76 75 76 75 76 75 76 75 76 75 76 75 76 46 2 2 52 136 
139 116 97 98 116 47 49 49 49 49 49 49 49 49 50 73 74 73 74 73 74 73 74 73 74 73 74 73 74 73 74 73 74 73 74 73 74 73 74 73 74 73 74 73 74 46 2 2 52 136 
139 116 97 100 99 99 99 99 99 99 99 99 99 99 90 71 72 71 72 71 72 71 72 71 72 71 72 71 72 71 72 71 72 71 72 71 72 71 72 71 72 71 72 71 72 46 2 2 52 136 
139 116 95 93 93 93 93 93 93 93 93 93 93 101 91 75 76 75 76 75 76 75 76 75 76 75 76 75 76 75 76 75 76 75 76 75 76 75 76 75 76 75 76 75 76 46 2 2 52 136 
139 75 76 75 76 75 76 75 76 75 76 75 76 92 91 73 74 73 74 73 74 73 74 73 74 73 74 73 74 73 74 73 74 73 74 73 74 73 74 73 74 73 74 73 74 46 2 2 52 136 
139 73 74 73 74 73 74 73 74 73 74 73 74 92 91 71 72 71 72 71 72 71 72 71 72 71 72 71 72 71 72 71 72 71 72 71 72 71 72 71 72 71 72 71 72 46 2 2 52 136 
139 71 72 71 72 71 72 71 72 71 72 71 72 92 91 75 76 75 76 75 76 75 76 75 76 75 76 75 76 75 76 117 117 117 117 117 45 48 48 48 48 48 48 48 48 114 2 2 52 136 
139 75 76 75 76 75 76 53 54 55 56 75 76 92 91 73 74 73 74 73 74 73 74 73 74 73 74 73 74 73 74 0 0 116 0 119 46 2 2 2 2 2 2 2 2 2 2 2 52 136 
139 73 74 73 74 73 74 57 58 59 60 73 74 92 91 71 72 71 72 71 72 71 72 71 72 71 72 71 72 71 72 0 0 0 0 119 46 2 2 2 2 2 2 2 2 2 2 2 52 136 
139 71 72 71 72 71 72 104 105 106 107 71 72 92 101 89 89 89 89 89 89 89 89 89 89 89 89 89 89 89 89 89 0 0 116 119 46 2 2 2 2 2 2 2 2 2 2 2 52 136 
139 45 48 48 48 48 51 108 109 110 111 116 116 92 101 101 93 93 93 93 93 93 93 93 101 101 93 93 93 93 93 93 0 0 0 119 46 2 2 2 2 2 2 2 2 2 2 2 52 136 
139 46 2 2 2 2 52 116 97 103 99 99 99 101 101 93 75 76 75 76 75 76 75 76 92 91 75 76 75 76 75 76 116 0 0 119 46 2 2 2 2 2 2 2 2 2 2 2 52 136 
139 46 2 2 2 2 115 51 95 93 93 93 101 101 94 116 73 74 73 74 73 74 73 74 92 91 73 74 73 74 73 74 0 0 0 119 47 49 49 49 49 49 49 49 49 49 49 49 50 136 
139 46 2 2 2 2 2 115 48 48 51 0 92 91 0 0 71 72 71 72 71 72 71 72 92 91 71 72 71 72 71 72 117 118 118 118 0 0 0 0 116 0 0 0 0 0 0 0 0 136 
139 46 2 2 2 2 2 2 2 2 52 0 92 91 75 76 75 76 75 76 75 76 75 76 92 91 0 0 0 0 0 0 0 0 0 0 0 0 0 0 0 0 0 0 0 0 0 0 0 136 
139 46 2 2 2 2 2 2 2 2 52 0 92 91 73 74 73 74 73 74 73 74 73 74 92 101 88 88 88 88 88 88 88 88 88 88 88 88 88 88 88 88 88 88 88 88 88 88 88 146 
139 46 2 2 2 2 2 2 2 2 52 0 92 91 71 72 71 72 71 72 71 72 71 72 92 91 0 174 173 172 0 0 0 0 0 116 177 186 188 0 0 0 0 0 0 116 0 0 0 136 
139 46 2 2 2 2 2 2 2 2 52 0 92 91 75 76 75 76 75 76 75 76 75 76 92 91 168 169 170 171 0 0 0 0 0 0 185 175 187 0 0 45 48 48 48 48 48 48 51 136 
139 46 2 2 2 2 2 2 2 2 52 0 92 91 73 74 73 74 73 74 73 74 73 74 92 91 167 166 165 164 116 0 0 0 0 0 183 178 176 184 0 46 2 2 2 2 2 2 52 136 
139 47 49 49 49 49 49 49 49 49 50 0 92 91 71 72 71 72 71 72 71 72 71 72 92 91 160 161 162 163 0 0 0 0 0 0 179 180 181 182 0 47 49 49 113 2 2 2 52 136 
139 117 118 118 118 118 118 118 118 118 118 118 92 91 118 118 118 118 75 76 75 76 75 76 92 91 116 92 91 0 116 0 0 0 0 0 116 189 0 0 116 117 118 118 46 2 2 2 52 136 
139 0 0 0 0 0 0 0 0 0 0 0 0 0 0 0 0 119 73 74 73 74 73 74 92 101 89 101 101 89 89 89 89 89 89 89 89 101 88 88 88 0 116 119 46 2 2 2 52 136 
139 0 0 0 116 0 0 0 0 0 0 0 0 0 0 0 0 119 71 72 71 72 71 72 102 93 93 93 93 93 93 93 93 93 93 93 93 94 117 118 118 118 118 118 46 2 2 2 52 136 
139 0 0 0 0 0 0 0 0 0 0 0 0 116 0 0 0 119 75 76 75 76 75 76 75 76 75 76 75 76 75 76 75 76 75 76 75 76 75 76 75 76 75 76 46 2 2 2 52 136 
139 0 0 0 0 0 0 0 0 0 0 0 0 0 0 0 0 119 73 74 73 74 73 74 73 74 73 74 73 74 73 74 73 74 73 74 73 74 73 74 73 74 73 74 46 2 2 2 52 136 
139 0 0 0 0 0 0 0 0 0 0 0 0 0 0 0 0 119 71 72 71 72 71 72 71 72 71 72 71 72 71 72 71 72 71 72 71 72 71 72 71 72 71 72 46 2 2 2 52 136 
139 0 0 0 0 0 0 116 0 0 0 116 0 0 0 0 0 119 75 76 75 76 75 76 75 76 75 76 75 76 75 76 75 76 75 76 75 76 75 76 75 76 75 76 46 2 2 2 52 136 
139 0 0 0 0 0 0 0 0 0 0 0 0 0 0 0 0 119 73 74 73 74 73 74 73 74 73 74 73 74 73 74 73 74 73 74 73 74 73 74 73 74 73 74 46 2 2 2 52 136 
139 0 0 0 116 0 0 0 0 0 0 0 0 0 0 116 0 119 71 72 71 72 71 72 71 72 71 72 71 72 71 72 71 72 71 72 71 72 71 72 71 72 71 72 46 2 2 2 52 136 
139 0 0 0 0 0 0 0 0 116 0 0 0 0 0 0 0 119 75 76 75 76 75 76 75 76 75 76 75 76 75 76 75 76 75 76 75 76 75 76 75 76 75 76 46 2 2 2 52 136 
139 0 0 0 0 0 0 0 0 0 0 0 0 0 0 0 0 119 73 74 73 74 73 74 73 74 73 74 73 74 73 74 73 74 73 74 73 74 73 74 73 74 73 74 46 2 2 2 52 136 
139 117 118 118 118 118 118 118 118 118 118 118 118 118 118 118 118 118 71 72 71 72 71 72 71 72 71 72 71 72 71 72 71 72 71 72 71 72 71 72 71 72 71 72 47 49 49 49 50 136 
139 45 48 48 48 48 48 48 48 48 48 48 48 48 48 48 51 75 76 75 76 75 76 75 76 75 76 75 76 75 76 75 76 75 76 75 76 75 76 75 76 75 76 75 76 75 76 75 76 136 
139 46 2 2 2 2 2 2 2 2 2 2 2 2 2 2 52 73 74 73 74 73 74 73 74 73 74 73 74 73 74 73 74 73 74 73 74 73 74 73 74 73 74 73 74 73 74 73 74 136 
139 46 2 2 2 2 2 2 2 2 2 2 2 2 2 2 52 71 72 71 72 71 72 71 72 71 72 71 72 71 72 71 72 71 72 71 72 71 72 71 72 71 72 71 72 71 72 71 72 136 
139 46 2 2 2 2 2 2 2 2 2 2 2 2 2 2 52 75 76 75 76 75 76 75 76 75 76 75 76 75 76 75 76 75 76 75 76 75 76 75 76 75 76 75 76 75 76 75 76 136 
139 46 2 2 2 2 2 2 2 2 2 2 2 2 2 2 52 73 74 73 74 73 74 73 74 73 74 73 74 73 74 73 74 73 74 73 74 73 74 73 74 73 74 73 74 73 74 73 74 136 
139 47 49 49 49 49 49 49 49 49 49 49 49 49 49 49 50 71 72 71 72 71 72 71 72 71 72 71 72 71 72 71 72 71 72 71 72 71 72 71 72 71 72 71 72 71 72 71 72 136 
142 134 134 134 134 134 134 134 134 134 134 134 134 134 134 134 134 134 134 134 134 134 134 134 134 134 134 134 134 134 134 134 134 134 134 134 134 134 134 134 134 134 134 134 134 134 134 134 134 141 
130 130 130 130 130 130 130 130 130 130 130 130 130 130 130 130 130 130 130 130 130 130 130 130 130 130 130 130 130 130 130 130 130 130 130 130 130 130 130 130 130 130 130 130 130 130 130 130 130 130 
130 130 130 130 130 130 130 130 130 130 130 130 130 130 130 130 130 130 130 130 130 130 130 130 130 130 130 130 130 130 130 130 130 130 130 130 130 130 130 130 130 130 130 130 130 130 130 130 130 130 
130 130 130 130 130 130 130 130 130 130 130 130 130 130 130 130 130 130 130 130 130 130 130 130 130 130 130 130 130 130 130 130 130 130 130 130 130 130 130 130 130 130 130 130 130 130 130 130 130 130 
130 130 130 130 130 130 130 130 130 130 130 130 130 130 130 130 130 130 130 130 130 130 130 130 130 130 130 130 130 130 130 130 130 130 130 130 130 130 130 130 130 130 130 130 130 130 130 130 130 130 
