130 130 130 130 130 130 130 130 130 130 130 130 130 130 130 130 130 130 130 130 130 130 130 130 130 130 130 130 130 130 130 130 130 130 130 130 130 130 130 130 130 130 130 130 130 130 130 130 130 130 
130 130 130 130 130 130 130 130 130 130 130 130 130 130 130 130 130 130 130 130 130 130 130 130 130 130 130 130 130 130 130 130 130 130 130 130 130 130 130 130 130 130 130 130 130 130 130 130 130 130 
130 130 130 130 130 130 130 130 130 130 130 130 130 130 130 130 130 130 130 130 130 130 130 130 130 130 130 130 130 130 130 130 130 130 130 130 130 130 130 130 130 130 130 130 130 130 130 130 130 130 
130 130 130 130 130 130 130 130 130 130 130 130 130 130 130 130 130 130 130 130 130 130 130 130 130 130 130 130 130 130 130 130 130 130 130 130 130 130 130 130 130 130 130 130 130 130 130 130 130 130 
130 130 130 130 130 130 130 130 130 130 130 130 130 130 130 130 130 130 130 130 130 130 130 130 130 130 130 130 130 130 130 130 130 130 130 130 130 130 130 130 130 130 130 130 130 130 130 130 130 130 
130 130 130 130 130 130 130 130 130 130 130 130 130 130 130 130 130 130 130 130 130 130 130 130 130 130 130 130 130 130 130 130 130 130 130 130 130 130 130 130 130 130 130 130 130 130 130 130 130 130 
130 130 130 130 130 130 130 130 130 130 130 130 130 130 130 130 130 130 130 130 130 130 130 130 130 130 130 130 130 130 130 130 130 130 130 130 130 130 130 130 130 130 130 130 130 130 130 130 130 130 
130 130 130 130 130 130 130 130 130 130 130 130 130 130 130 130 130 130 130 130 130 130 130 130 130 130 130 130 130 130 130 130 130 130 130 130 130 130 130 130 130 130 130 130 130 130 130 130 130 130 
130 130 130 130 130 130 130 130 130 130 130 130 130 130 130 130 130 130 130 130 130 130 130 130 130 130 130 130 130 130 130 130 130 130 130 130 130 130 130 130 130 130 130 130 130 130 130 130 130 130 
130 130 130 130 130 130 130 130 130 130 130 130 130 130 130 130 130 130 130 130 130 130 130 130 130 130 130 130 130 130 130 130 130 130 130 130 130 130 130 130 130 130 130 130 130 130 130 130 130 130 
130 130 130 130 130 130 130 130 130 130 130 130 130 130 130 130 130 130 130 130 130 130 130 130 130 130 130 130 130 130 130 130 130 130 130 130 130 130 130 130 130 130 130 130 130 130 130 130 130 130 
130 130 130 130 130 130 130 130 130 130 130 130 130 130 130 130 130 130 130 130 130 130 130 130 130 130 130 130 130 130 130 130 130 130 130 130 130 130 130 130 130 130 130 130 130 130 130 130 130 130 
130 130 130 130 130 130 130 130 130 130 130 130 130 130 130 130 130 130 130 130 130 130 130 130 130 130 130 130 130 130 130 130 130 130 130 130 130 130 130 130 130 130 130 130 130 130 130 130 130 130 
130 130 130 130 130 130 130 130 130 130 130 130 130 130 130 130 130 130 130 130 130 130 130 130 130 130 130 130 130 130 130 130 130 130 130 130 130 130 130 130 130 130 130 130 130 130 130 130 130 130 
130 130 130 130 130 130 130 130 130 130 130 130 130 130 130 130 130 130 130 130 130 130 130 130 130 130 130 130 130 130 130 130 144 129 129 129 132 130 130 130 130 130 130 130 130 130 130 130 130 130 
130 130 130 130 130 130 130 130 130 130 130 130 130 130 130 130 130 130 144 129 129 129 129 129 129 129 129 129 129 129 132 130 141 125 125 125 125 129 129 129 129 132 130 130 130 130 130 130 130 130 
130 130 130 130 130 130 130 130 130 130 130 130 130 130 130 130 130 130 141 125 125 125 142 134 141 128 128 128 128 128 131 130 139 126 126 128 125 125 125 125 128 131 130 130 130 130 130 130 130 130 
130 130 130 130 130 130 130 130 130 130 130 130 130 130 130 130 130 130 139 126 15 126 143 130 139 126 15 126 126 128 131 130 139 127 127 126 126 126 126 126 128 131 130 130 130 130 130 130 130 130 
130 130 130 130 130 130 130 130 130 130 130 130 130 130 130 130 130 130 139 127 127 127 143 130 139 127 127 15 127 128 131 130 139 127 127 127 127 127 127 127 146 131 130 130 130 130 130 130 130 130 
130 130 130 130 130 130 130 130 130 130 130 130 130 130 130 130 130 130 139 12 12 13 137 129 140 13 14 12 12 128 131 130 139 127 15 127 127 127 127 127 128 131 130 130 130 130 130 130 130 130 
130 130 130 130 130 130 130 130 130 130 130 130 130 130 130 130 130 130 139 127 127 127 127 127 127 127 127 127 127 128 131 130 139 127 127 127 127 127 127 127 128 131 130 130 130 130 130 130 130 130 
130 130 130 130 130 130 130 130 130 130 130 130 130 130 130 130 130 130 139 127 127 127 127 127 127 127 127 127 127 128 131 130 139 127 127 127 127 127 127 127 128 131 130 130 130 130 130 130 130 130 
130 130 130 130 130 130 130 130 130 130 130 130 130 130 130 130 130 130 139 127 127 127 127 127 15 133 134 134 134 134 130 130 139 127 127 133 134 134 134 134 134 130 130 130 130 130 130 130 130 130 
130 130 130 130 130 130 130 130 130 130 130 130 130 130 130 130 130 130 139 127 127 127 127 127 127 136 130 130 130 130 130 130 139 127 127 131 144 129 129 129 129 129 129 129 129 129 129 129 132 130 
130 130 130 130 130 130 130 130 130 130 130 130 130 130 130 130 130 130 130 134 134 138 127 127 127 135 129 129 129 129 129 129 140 127 127 131 141 125 125 125 125 125 125 125 125 125 125 125 131 130 
130 130 130 130 130 130 130 144 129 129 129 129 129 129 129 129 129 129 129 129 129 140 127 127 127 128 125 125 125 125 125 125 125 127 127 131 139 126 126 126 126 126 126 126 126 126 126 128 131 130 
130 130 130 130 130 130 130 139 126 126 126 126 126 126 126 126 126 126 126 126 126 126 127 127 127 126 126 126 126 126 126 126 15 127 127 131 139 127 127 127 127 127 127 127 127 127 127 128 131 130 
130 130 130 130 130 130 130 139 127 127 127 127 15 127 127 127 127 127 127 127 127 127 127 127 127 127 127 127 127 127 127 127 127 127 127 131 139 127 127 127 127 15 127 15 127 127 127 128 131 130 
130 130 130 130 130 130 130 139 127 127 127 127 127 127 127 127 127 127 127 127 127 127 127 127 127 127 127 127 127 127 127 127 127 127 127 131 139 127 127 127 127 127 127 127 127 127 127 128 131 130 
130 130 130 130 130 130 130 139 127 133 134 134 134 134 134 134 134 134 134 134 134 134 134 134 134 134 134 134 134 134 134 138 127 127 127 131 139 127 127 127 127 127 127 127 127 127 127 128 131 130 
144 129 129 129 129 132 130 139 127 137 129 129 129 129 129 129 129 129 132 130 130 130 130 130 130 130 130 130 130 130 130 139 127 127 127 131 134 134 134 134 134 134 134 138 127 127 127 128 131 130 
139 126 126 126 126 131 130 139 127 126 126 126 126 126 126 126 126 126 131 130 130 130 130 130 130 130 130 130 130 130 130 139 127 127 127 128 129 129 129 129 129 129 129 140 13 14 12 128 131 130 
139 127 127 127 127 131 130 139 127 127 127 127 127 127 127 127 127 127 131 130 130 130 130 130 130 130 130 130 130 130 130 139 127 15 127 126 126 126 126 126 126 126 126 126 127 127 127 128 131 130 
139 127 127 127 127 131 130 139 127 127 127 127 127 127 15 127 127 127 131 130 130 130 130 130 130 130 130 130 130 130 130 139 127 127 127 133 134 134 134 134 134 134 134 134 134 134 134 134 134 130 
139 127 127 127 127 137 129 140 127 127 15 127 127 127 127 127 127 127 131 130 130 130 130 130 130 130 130 144 129 129 129 140 12 13 14 128 129 129 132 130 130 130 130 130 130 130 130 130 130 130 
139 127 127 127 127 126 126 126 127 127 127 127 127 127 127 127 127 127 131 130 130 130 130 130 130 130 130 139 127 127 127 127 127 127 126 126 127 127 131 130 130 130 130 130 130 130 130 130 130 130 
139 127 127 127 127 127 127 127 127 127 127 127 127 127 127 127 127 127 131 130 130 130 130 130 130 130 130 139 127 127 127 127 127 127 127 127 127 127 131 130 130 130 130 130 130 130 130 130 130 130 
139 127 127 127 15 127 127 127 127 127 127 127 127 127 127 127 127 127 131 130 130 130 130 130 130 130 130 139 127 127 127 127 127 127 127 127 127 127 131 130 130 130 130 130 130 130 130 130 130 130 
139 127 127 127 127 127 127 127 127 127 127 127 15 127 127 127 127 127 131 130 130 130 130 130 130 130 130 139 127 127 127 127 127 127 127 127 127 127 131 130 130 130 130 130 130 130 130 130 130 130 
139 127 127 127 127 127 127 127 127 127 127 127 127 127 127 127 127 127 131 130 130 130 130 130 130 130 130 134 134 134 134 134 134 134 134 134 134 134 134 130 130 130 130 130 130 130 130 130 130 130 
139 127 127 127 127 127 127 127 127 127 127 127 127 127 127 127 127 127 131 130 130 130 130 130 130 130 130 130 130 130 130 130 130 130 130 130 130 130 130 130 130 130 130 130 130 130 130 130 130 130 
139 127 127 127 127 127 127 127 127 127 127 127 127 127 127 127 127 127 131 130 130 130 130 130 130 130 130 130 130 130 130 130 130 130 130 130 130 130 130 130 130 130 130 130 130 130 130 130 130 130 
139 127 127 127 127 127 127 127 127 127 127 127 127 127 127 127 127 127 131 130 130 130 130 130 130 130 130 130 130 130 130 130 130 130 130 130 130 130 130 130 130 130 130 130 130 130 130 130 130 130 
139 127 127 127 127 127 127 127 127 127 127 127 127 127 127 127 127 127 131 130 130 130 130 130 130 130 130 130 130 130 130 130 130 130 130 130 130 130 130 130 130 130 130 130 130 130 130 130 130 130 
139 127 127 127 127 127 127 127 127 127 127 127 127 127 127 127 127 127 131 130 130 130 130 130 130 130 130 130 130 130 130 130 130 130 130 130 130 130 130 130 130 130 130 130 130 130 130 130 130 130 
139 127 127 127 127 127 127 127 133 134 134 134 134 134 134 134 134 134 134 130 130 130 130 130 130 130 130 130 130 130 130 130 130 130 130 130 130 130 130 130 130 130 130 130 130 130 130 130 130 130 
139 127 127 127 127 127 127 127 143 130 130 130 130 130 130 130 130 130 130 130 130 130 130 130 130 130 130 130 130 130 130 130 130 130 130 130 130 130 130 130 130 130 130 130 130 130 130 130 130 130 
139 127 127 127 127 127 127 127 128 129 129 129 129 129 129 129 129 129 132 130 130 130 130 130 130 130 130 130 130 130 130 130 130 130 130 130 130 130 130 130 130 130 130 130 130 130 130 130 130 130 
139 127 127 127 127 127 127 127 126 126 126 126 126 126 126 126 15 19 131 130 130 130 130 130 130 130 130 130 130 130 130 130 130 130 130 130 130 130 130 130 130 130 130 130 130 130 130 130 130 130 
134 134 145 134 134 134 134 134 134 134 134 134 134 134 134 134 134 134 134 130 130 130 130 130 130 130 130 130 130 130 130 130 130 130 130 130 130 130 130 130 130 130 130 130 130 130 130 130 130 130 
