144 129 129 129 129 129 129 129 129 129 129 129 129 129 129 129 129 129 132 130 130 130 130 130 130 130 130 130 130 130 130 130 130 130 130 130 130 130 130 130 130 130 130 130 130 130 130 130 130 130 
139 9 9 9 9 9 9 9 9 9 9 9 9 9 9 9 9 9 131 130 130 130 130 130 130 130 130 130 130 130 130 130 130 130 130 130 130 130 130 130 130 130 130 130 130 130 130 130 130 130 
139 10 10 10 10 10 10 10 10 10 10 10 10 10 10 10 10 10 131 130 130 130 130 130 130 130 130 130 130 130 130 130 130 130 130 130 130 130 130 130 130 130 130 130 130 130 130 130 130 130 
139 9 9 9 9 9 9 9 9 9 9 9 9 9 9 9 9 9 131 130 130 130 130 130 130 130 130 130 130 130 130 130 130 130 130 130 130 130 130 130 130 130 130 130 130 130 130 130 130 130 
139 10 10 10 10 10 10 10 10 10 10 10 10 10 10 10 10 10 131 130 130 130 130 130 130 130 130 130 130 130 130 130 130 130 130 130 130 130 130 130 130 130 130 130 130 130 130 130 130 130 
147 120 120 120 120 120 120 120 120 120 120 120 89 79 9 9 9 9 131 130 130 130 130 130 130 130 130 130 130 130 130 130 130 130 130 130 130 130 130 130 130 130 130 130 130 130 130 130 130 130 
139 9 9 9 9 9 9 9 9 9 9 9 81 80 10 10 10 10 131 130 130 130 130 130 130 130 130 130 130 130 130 130 130 130 130 130 130 130 130 130 130 130 130 130 130 130 130 130 130 130 
139 10 10 10 10 10 10 10 10 10 10 10 81 80 9 9 9 9 131 130 130 130 130 130 130 130 130 130 130 130 130 130 130 130 130 130 130 130 130 130 130 130 130 130 130 130 130 130 130 130 
139 9 9 9 9 9 9 9 9 9 9 9 81 80 10 10 10 10 131 130 130 130 130 130 130 130 130 130 130 130 130 130 130 130 130 130 130 130 130 130 130 130 130 130 130 130 130 130 130 130 
139 10 10 10 10 10 10 10 10 10 10 10 81 80 9 9 9 9 131 130 130 130 130 130 130 130 130 130 130 130 130 130 130 130 130 130 130 130 130 130 130 130 130 130 130 130 130 130 130 130 
139 11 20 21 11 45 48 48 48 48 48 51 81 80 10 10 10 10 131 130 130 130 130 130 130 130 130 130 130 130 130 130 130 130 130 130 130 130 130 130 130 130 130 130 130 130 130 130 130 130 
139 22 23 24 25 46 2 2 2 2 2 52 81 80 9 9 9 9 131 130 130 130 130 130 130 130 130 130 130 130 130 130 130 130 130 130 130 130 130 130 130 130 130 130 130 130 130 130 130 130 
139 26 27 28 29 46 2 2 2 2 2 52 81 80 10 10 10 10 131 130 130 130 130 130 130 130 130 130 130 130 130 130 130 130 130 130 130 130 130 130 130 130 130 130 130 130 130 130 130 130 
139 30 31 32 33 46 2 2 2 2 2 52 81 80 9 9 9 9 131 130 130 130 130 130 130 130 130 130 130 130 130 130 130 130 130 130 130 130 130 130 130 130 130 130 130 130 130 130 130 130 
139 11 86 87 11 47 49 49 49 49 49 50 81 80 10 10 10 10 128 129 129 132 130 130 130 130 130 130 130 130 130 130 130 130 130 130 130 130 130 130 130 130 130 130 130 130 130 130 130 130 
139 11 86 103 78 78 78 78 78 78 78 78 101 80 9 9 9 9 9 9 9 131 130 130 130 130 130 130 130 130 130 130 130 130 130 130 130 130 130 130 130 130 130 130 130 130 130 130 130 130 
139 11 84 82 82 82 82 82 82 82 82 82 101 80 10 10 10 10 10 10 10 131 130 130 130 130 130 130 130 130 130 130 130 130 130 130 130 130 130 130 130 130 130 130 130 130 130 130 130 130 
139 45 48 48 48 48 48 48 48 48 48 51 81 80 9 9 9 9 9 9 9 131 130 130 130 130 130 130 130 130 130 130 130 130 130 130 130 130 130 130 130 130 130 130 130 130 130 130 130 130 
139 46 2 2 2 2 2 2 2 2 2 52 81 80 10 10 10 10 10 10 10 131 130 130 130 130 130 130 130 130 130 130 130 130 130 130 130 130 130 130 130 130 130 130 130 130 130 130 130 130 
139 46 2 2 2 2 2 2 2 2 2 52 81 80 148 153 9 9 9 9 9 131 130 130 130 130 130 130 130 130 130 130 130 130 130 130 130 130 130 130 130 130 130 130 130 130 130 130 130 130 
139 46 2 2 2 2 2 2 2 2 2 52 81 80 149 154 10 10 10 10 10 131 130 130 130 130 130 130 130 130 130 130 130 130 130 130 130 130 130 130 130 130 130 130 130 130 130 130 130 139 
139 46 2 2 2 2 2 2 2 2 2 52 81 80 150 154 9 9 9 9 9 131 130 130 130 130 130 130 130 130 130 130 130 130 130 130 130 130 130 130 130 130 130 130 130 130 130 130 130 130 
139 46 2 2 2 2 2 2 2 2 2 52 81 80 150 154 10 10 10 10 10 131 130 130 130 130 130 130 130 130 130 130 130 130 130 130 130 130 130 130 130 130 130 130 130 130 130 130 130 130 
139 46 2 2 2 2 2 2 2 2 2 52 81 80 151 156 9 9 9 9 9 131 130 130 130 130 130 130 130 130 130 130 130 130 130 130 130 130 130 130 130 130 130 130 130 130 130 130 130 130 
139 46 2 2 2 2 2 2 2 2 2 52 81 80 152 157 10 10 10 10 10 131 130 130 130 130 130 130 130 130 130 130 130 130 130 130 130 130 130 130 130 130 130 130 130 130 130 130 130 130 
139 46 2 2 2 2 2 2 2 2 2 52 81 80 148 153 9 9 9 9 9 131 130 130 130 130 130 130 130 130 130 130 130 130 130 130 130 130 130 130 130 130 130 130 130 130 130 130 130 130 
139 46 2 2 2 2 2 2 2 2 2 52 81 80 149 155 10 10 10 10 10 128 129 129 129 129 129 129 129 129 129 129 129 129 129 129 129 129 129 129 129 129 129 129 129 129 129 132 130 130 
139 46 2 2 2 2 2 2 2 2 2 52 81 80 150 154 9 9 9 9 9 9 9 9 9 9 9 9 9 9 9 9 9 9 9 9 9 9 9 9 9 9 9 9 9 9 9 131 130 130 
139 46 2 2 2 2 2 2 2 2 2 52 81 80 150 154 10 10 10 10 10 10 10 10 10 10 10 10 10 10 10 10 10 10 10 10 10 10 10 10 10 10 10 10 10 10 10 131 130 130 
139 46 2 2 2 2 2 2 2 2 2 52 81 80 151 156 9 9 9 9 9 9 9 9 9 9 9 9 9 9 9 9 9 9 9 9 9 9 9 9 9 9 9 9 9 9 9 131 130 130 
139 46 2 2 2 2 2 2 2 2 2 52 81 80 152 157 10 10 10 10 10 10 10 10 10 10 10 10 10 10 10 10 10 10 10 10 10 10 10 10 10 10 10 10 10 10 10 131 130 130 
139 46 2 2 2 2 2 2 2 2 2 52 81 80 45 48 48 48 51 148 153 11 20 21 11 148 153 9 9 9 9 9 9 9 9 9 9 9 9 11 11 11 11 11 9 9 9 131 130 130 
139 46 2 2 2 2 2 2 2 2 2 52 81 80 46 2 2 2 52 149 155 22 23 24 25 149 155 10 10 10 10 10 10 10 10 10 10 10 10 11 11 11 11 11 10 10 10 131 130 130 
139 46 2 2 2 2 2 2 2 2 2 52 81 80 46 2 2 2 52 151 156 26 27 28 29 151 156 9 9 9 9 9 9 9 9 9 9 9 9 11 11 11 11 11 9 9 9 131 130 130 
139 46 2 2 2 2 2 2 2 2 2 52 81 80 47 49 49 49 50 152 157 121 122 123 124 152 157 10 10 10 10 10 10 10 10 10 10 10 10 11 11 11 11 11 10 10 10 131 130 130 
139 46 2 2 2 2 2 2 2 2 2 52 81 101 78 78 78 78 78 78 78 78 78 79 11 11 11 9 9 9 9 9 9 9 9 9 9 9 9 11 11 11 11 11 9 9 9 131 130 130 
139 46 2 2 2 2 2 2 2 2 2 52 102 93 82 82 82 82 82 82 82 82 82 83 11 11 11 10 10 10 10 10 10 10 10 10 10 10 10 11 11 11 11 11 10 10 10 131 130 130 
139 46 2 2 2 2 2 2 2 2 2 52 9 9 9 9 9 9 9 9 9 9 9 9 9 9 9 9 9 9 9 9 9 9 9 9 9 9 9 9 9 9 9 9 9 9 9 131 130 130 
139 47 49 49 49 49 49 49 49 49 49 50 10 10 10 10 10 10 10 10 10 10 10 10 10 10 10 10 10 10 10 10 10 10 10 10 10 10 10 10 10 10 10 10 10 10 10 131 130 130 
139 9 9 9 9 9 9 9 9 9 9 9 9 9 9 9 9 9 9 9 9 9 9 9 9 9 9 9 9 9 9 9 9 9 9 9 9 9 9 9 9 9 9 9 9 9 9 131 130 130 
139 10 10 10 10 10 10 10 10 10 10 10 10 10 10 10 10 10 10 10 10 10 10 10 10 10 10 10 10 10 10 10 10 10 10 10 10 10 10 10 10 10 10 10 10 10 10 131 130 130 
134 134 134 134 134 134 134 134 134 134 134 134 134 134 134 134 134 134 134 134 134 134 134 134 134 134 134 134 134 134 134 134 134 134 134 134 134 134 134 134 134 134 134 134 134 134 134 130 130 130 
130 130 130 130 130 130 130 130 130 130 130 130 130 130 130 130 130 130 130 130 130 130 130 130 130 130 130 130 130 130 130 130 130 130 130 130 130 130 130 130 130 130 130 130 130 130 130 130 130 130 
130 130 130 130 130 130 130 130 130 130 130 130 130 130 130 130 130 130 130 130 130 130 130 130 130 130 130 130 130 130 130 130 130 130 130 130 130 130 130 130 130 130 130 130 130 130 130 130 130 130 
130 130 130 130 130 130 130 130 130 130 130 130 130 130 130 130 130 130 130 130 130 130 130 130 130 130 130 130 130 130 130 130 130 130 130 130 130 130 130 130 130 130 130 130 130 130 130 130 130 130 
130 130 130 130 130 130 130 130 130 130 130 130 130 130 130 130 130 130 130 130 130 130 130 130 130 130 130 130 130 130 130 130 130 130 130 130 130 130 130 130 130 130 130 130 130 130 130 130 130 130 
130 130 130 130 130 130 130 130 130 130 130 130 130 130 130 130 130 130 130 130 130 130 130 130 130 130 130 130 130 130 130 130 130 130 130 130 130 130 130 130 130 130 130 130 130 130 130 130 130 130 
130 130 130 130 130 130 130 130 130 130 130 130 130 130 130 130 130 130 130 130 130 130 130 130 130 130 130 130 130 130 130 130 130 130 130 130 130 130 130 130 130 130 130 130 130 130 130 130 130 130 
144 129 129 129 129 129 129 129 129 129 129 129 129 129 129 129 129 129 129 129 129 129 129 129 129 129 129 129 129 129 129 129 129 129 129 129 129 129 129 129 129 129 129 129 129 129 129 129 129 129 
140 125 125 125 125 125 125 125 125 125 125 125 125 125 125 125 125 125 125 125 125 125 125 125 125 125 125 125 125 125 125 125 125 125 125 125 125 125 125 125 125 125 125 125 125 125 125 125 125 125 
